-9
9
-5
5
0000000000000000000
0000000000000000000
0010000000000000000
0010000000000000000
0010000000000000000
0111000000000000000
1111111100000000000
0111000000000000000
0011110000000000000
0111110000000000000
1110000000000000000
